50 36
52222222222222222222222222222222222222222222222225
63000000000000000000000000000000000000000000000014
60000000000000000000000000000000000000000000000004
60000000000000000000000000000000000000000000000004
60000000000000000000000000000000000000000000000004
60000000000000000000000000000000000000000000000004
60000000000000000000000000000000000000000000000004
60000000000000000000000000000000000000000000000004
60000000000000000000000000000000000000000000000004
60000000000000000000000000000000000000000000000004
60000000000000000000000000000000000000000000000004
60000000000000000000000000000000000000000000000004
60000000000000000000000000000000000000000000000004
60000000000000000000000000000000000000000000000004
60000000000000000000000000000000000000000000000004
60000000000000000000000000000000000000000000000004
60000000000000000000000000000000000000000000000004
60000000000000000000000000000000000000000000000004
60000000000000000000000000000000000000000000000004
60000000000000000000000000000000000000000000000004
60000000000000000000000000000000000000000000000004
60000000000000000000000000000000000000000000000004
60000000000000000000000000000000000000000000000004
60000000000000000000000000000000000000000000000004
60000000000000000000000000000000000000000000000004
60000000000000000000000000000000000000000000000004
60000000000000000000000000000000000000000000000004
60000000000000000000000000000000000000000000000004
60000000000000000000000000000000000000000000000004
60000000000000000000000000000000000000000000000004
60000000000000000000000000000000000000000000000004
60000000000000000000000000000000000000000000000004
60000000000000000000000000000000000000000000000004
60000000000000000000000000000000000000000000000004
69000000000000000000000000000000000000000000000074
58888888888888888888888888888888888888888888888885