50 36
52222222222222222222222222222222222222222222222225
66666666666666000000000000000000000044444444444444
66666666666666000000000000000000000044444444444444
66666666666666000000000000000000000044444444444444
66666666666666000000000000000000000044444444444444
66666666666666000000000000000000000044444444444444
68888888888886000000000000000000000048888888888884
62222222222223000000000000000000000012222222222224
60000000000000000000000000000000000000000000000004
60000000000000000000000000000000000000000000000004
60000000000000000000000000000000000000000000000004
60000000000000000000000000000000000000000000000004
60000000000000000000000000000000000000000000000004
60000000000000007888888888888888890000000000000004
60000000000000001222222222222222230000000000000004
60000000000000000000000000000000000000000000000004
60000000000000000000000000000000000000000000000004
60000000000000000000000000000000000000000000000004
60000000000000000000000000000000000000000000000004
60000000000000000000000000000000000000000000000004
60000000000000000000000000000000000000000000000004
60000000000000000000000000000000000000000000000004
60000000000000000788888888888888900000000000000004
60000000000000000122222222222222300000000000000004
60000000000000000000000000000000000000000000000004
60000000000000000000000000000000000000000000000004
60000000000000000000000000000000000000000000000004
60000000000000000000000000000000000000000000000004
60000000000000000000000000000000000000000000000004
60000078888888889000000000000000078888888889000004
60000012222222223000000000000000012222222223000004
60000000000000000000000000000000000000000000000004
60000000000000000000000000000000000000000000000004
60000000000000000000000000000000000000000000000004
60000000000000000000000000000000000000000000000004
58888888888888888888888888888888888888888888888885